XXXXXXXXXXXXX
XXXXX       X
XXXXX     X X
Xp   #@  XFfX
XXXXX@@   ffX
X   X  XXXXdX
X k         X
X           X
XXXXXXXXXXXXX