XXXXXXXXXXXXX
X           X
XXXXXX     XX
XPp    Rr FfX
Xpp    rr ffX
XXXXXX   XXXX
X       X   X
X   #@      X
X   @@      X
XXXXXXXXXXXXX