XXXXXXXXXXXXX
X        X  X
XXXXXXXX  XXX
XPp     RrFfX
Xpp     rrffX
X  XXXX   XXX
X           X
X   #@      X
X   @@      X
XXXXXXXXXXXXX